R 10000 10000
NO ./srcs/sandstone.xpm
WE ./srcs/blue_box.xpm
EA ./srcs/purple_pillar.xpm
S  ./srcs/RIN.xpm
F 0,100,100
C 225,100,100
SO ./srcs/pillar_top.xpm
















        1111111111111111111111111
        1000000000110000000000001
        1011000001110000002000001
        100100000000S000000000011
        1011001001110000002000001
        1011001001110000002010001
        1011001001110000000010001
        1011001001110000002010001
        1011001001110000022200001
        1011001000000000002000001
        1011000111110000002000001
        1011000001110000002000001
        1011000001110000002000001
        1011000001110000002000001
        1011000001110000002000001
111111111111111111111111111111111
